🬹🬹🬹🬹🬹🬹🬹🬹🬹🬹🬹🬹🬹
█🯰🯱🯰▐:)█🯱🯰🯰▐█
█████████████
██∎∎∎∎∎∎∎∎∎██
██∎∎∎∎∎∎∎∎∎██
██∎∎∎∎∎∎∎∎∎██
██∎∎∎∎3∎∎∎∎██
██∎∎∎12⚑∎∎∎██
██∎∎∎∎∎∎∎∎∎██
██∎∎∎∎∎∎∎∎∎██
█████████████
⋇
⫯
⚑
🯱🯰🯰
🯰
▐
:/
¦[
